11111111111
10101000021
10000011111
10100000041
10000010111
13100000051
11111111111