11111111111
10101000021
10000411111
10100000001
10000010111
13100000051
11111111111