11111111111
10101000021
10000011111
10100004041
10000010111
13100004041
11111111111