11111111111
11111000001
10100011111
10101300201
10000010111
10101000051
11111111111