11111111111
10001000041
10101011111
10101000001
10101010111
12100000051
11111111111